###############################
#..######.........#....##....##
##.#.#...#.##.###.#.##.##.##..*
##.#.#.##..##.#.#.#.#...#...###
##.........##...#.#.#.#####.###
######.###.##.###.#.#.###...###
#......###.####.........#.#####
###.######....########..#.#####
###........###########.....####
###################.#####.#####
